0 0 0 256 256 6 0
1 105 50 100 100 0 0 1005 1005 1 0
2 0 50 1 256 1
2 300 50 1 256 1
8 0 0 1024 256 0 1 25 4 2 1 0
8 0 0 512 300 0 1 40 1 1 1 0
8 0 0 256 256 0 1 58 12 2 1 0

9 -50 0 50 250 27 1 3 0 1 0 255 0 0
9 300 0 50 250 27 1 3 0 1 0 255 0 0

11 200 200 200 12