0 2972 2603 256 256 6

2 2650 1529 1 256 1
2 2945 1529 1 256 1
2 767 484 1 256 1
2 1380 484 1 256 1
2 2785 484 1 256 1
2 3415 484 1 256 1
2 4995 484 1 256 1
2 5660 484 1 256 1
2 7140 484 1 256 1
2 7865 484 1 256 1

2 4207 1529 1 256 1
2 7349 1529 1 256 1

2 594 2603 1 256 1
2 1275 2603 1 256 1
2 2563 2603 1 256 1
2 7351 2603 1 256 1

3 4280 1529 256 256 1 7 1 35 1 1 0
3 4742 1529 256 256 1 7 2 35 1 1 0
3 5232 1529 256 256 1 7 3 35 1 1 0
3 5734 1529 256 256 1 7 4 35 1 1 0
3 6196 1529 256 256 1 7 5 35 1 1 0
3 6722 1529 256 256 1 7 6 35 1 1 0

3 7081 484 256 256 1 9 7 35 1 1 1
3 4959 484 256 256 1 9 8 35 1 1 1
3 2777 484 256 256 1 9 9 35 1 1 1
3 1153 484 256 256 1 9 10 35 1 1 1
3 2619 1529 256 256 1 9 11 35 1 1 1
3 1063 2603 256 256 1 9 12 35 1 1 1

3 7052 2603 256 256 1 14 13 35 1 0 0
3 7052 1529 256 256 1 13 14 35 1 0 0
3 6723 2603 256 256 3 0 15 35 0 1 0

6 4280 1529 256 256 1 0
6 4742 1529 256 256 1 0
6 5232 1529 256 256 1 0
6 5734 1529 256 256 1 0
6 6196 1529 256 256 1 0
6 6722 1529 256 256 1 0

6 7081 484 256 256 1 0
6 4959 484 256 256 1 0
6 2777 484 256 256 1 0
6 1153 484 256 256 1 0
6 2619 1529 256 256 1 0
6 1063 2603 256 256 1 0

6 800 2603 32 64 1 0
6 6723 2603 32 256 0 0

7 7175 2560 49
7 7175 1485 50

8 0 0 1024 256 0 1 25 4 2 1 0
8 0 0 512 256 0 1 40 1 1 1 0

9 2560 2603 256 256 35 1 1 0 5 1 255 0 0
9 4587 2603 256 256 35 1 1 0 5 1 255 0 0
9 800 2703 32 64 47 1 2 0 0 0 255 0 0
9 6723 2703 32 32 46 1 2 0 2 0 255 0 0
9 2983 2598 256 256 36 1 0 0 22 1 255 0 0

11 60 60 65 2