0 3000 0 256 256 6
2 -4098 0 1 256 1
4 1000 0 128 256 100 59 2
4 1222 0 128 256 100 60 2
4 1350 0 128 256 100 61 2
4 1550 0 128 256 100 62 2
4 1800 0 128 256 100 63 2
4 1928 0 128 256 100 64 2
4 2200 0 128 256 100 65 2
4 2328 0 128 256 100 66 2
6 5813 0 1000 256 1 0
8 0 0 1024 256 0 1 25 4 2 1 0
8 0 0 512 256 0 1 40 1 1 1 0
11 200 200 200 7