0 75 44 256 256 6 0

2 0 25 1 275 1
2 600 25 1 275 1

3 379 44 256 256 0 1 1 35 0 1 1 0

6 379 44 256 256 1 0

8 0 0 1024 256 0 1 25 4 2 1 0
8 0 0 512 256 0 1 40 1 1 1 0
8 0 0 256 256 0 1 58 11 2 1 0

8 -256 30 869 458 0 1 57 0 0 1 0
8 251 30 512 256 0 1 52 0 0 1 0

11 50 50 55 0