0 850 885 256 256 6 
1 100 901 240 240 0 4 100 300 21 1
1 850 236 256 256 0 2 850 550 22 1
2 0 0 1 1296 1 
2 1151 0 1 1296 1 
3 850 885 256 256 1 2 1 23 1
3 200 236 256 256 1 1 2 23 1
3 850 236 256 256 2 0 3 23 1
5 450 885 256 256 24