0 2850 368 256 256 6
2 2800 400 1 220 1
6 5500 368 50 256 1 0
6 6300 350 50 300 1 0
6 6840 350 50 300 1 0
6 3700 350 50 300 1 0
6 3400 350 50 300 0 0
7 2610 0 33
7 4110 0 32
8 0 0 0 1 25 4
8 0 0 0 1 40 1
9 0 0 7140 1080 30 1 2 0 1 0 255
9 0 0 7140 1080 31 1 2 0 1 0 0
9 0 0 7140 1080 37 1 0 0 1 0 255
9 0 0 7140 1080 38 1 2 0 1 0 0
9 5711 368 256 256 35 1 1 0 5 0 255
9 6486 368 256 256 36 1 1 0 22 1 255
9 4471 463 198 160 39 1 1 0 1 0 255
9 1500 623 3500 1080 27 1 2 0 1 0 255
11 200 200 205
