0 1780 1511 256 256 6
3 1342 1511 256 256 1 2 1 23 1
3 2554 2585 256 256 1 1 2 23 1
3 6719 2585 256 256 1 5 3 23 0
3 7070 2585 256 256 1 6 4 23 1
3 3594 1511 256 256 1 3 5 23 1
3 7019 1511 256 256 1 4 6 23 1
3 6432 1511 256 256 1 9 7 23 1
3 5907 1511 256 256 1 10 8 23 1
3 5907 461 256 256 1 7 9 23 1
3 3284 461 256 256 1 8 10 23 1
5 5565 2585 256 256 24
6 3870 555 48 43 1 0
6 4670 1410 50 256 1 0
7 2100 1511 24
8 0 0 0 1 25 4
8 0 0 0 1 40 1
11 0 0 0