0 2972 2603 256 256 6 0

2 2650 1529 1 256 1
2 2945 1529 1 256 1
2 767 484 1 256 1
2 1380 484 1 256 1
2 2785 484 1 256 1
2 3415 484 1 256 1
2 4995 484 1 256 1
2 5824 484 1 256 1
2 6926 484 1 256 1
2 8102 484 1 256 1

2 4207 1529 1 256 1
2 7349 1529 1 256 1

2 594 2603 1 256 1
2 1275 2603 1 256 1
2 2563 2603 1 256 1
2 7351 2603 1 256 1

2 368 1492 1 300 1
2 1197 1492 1 300 1

3 4280 1529 256 256 1 7 1 35 1 1 0 0
3 4742 1529 256 256 1 7 2 35 1 1 0 0
3 5236 1529 256 256 1 7 3 35 1 1 0 0
3 5729 1529 256 256 1 7 4 35 1 1 0 0
3 6196 1529 256 256 1 7 5 35 1 1 0 0
3 6725 1529 256 256 1 7 6 35 1 1 0 0

3 7081 487 256 256 1 9 7 35 1 1 1 0
3 4963 487 256 256 1 9 8 35 1 1 1 0
3 2777 484 256 256 1 9 9 35 1 1 1 0
3 1153 484 256 256 1 9 10 35 1 1 1 0
3 2619 1529 256 256 1 9 11 35 1 1 1 0
3 1063 2603 256 256 1 9 12 35 1 1 1 0

3 7052 2603 256 256 1 14 13 35 1 0 0 1
3 7052 1529 256 256 1 13 14 35 1 0 0 1
3 6725 2603 256 256 1 16 15 35 0 1 0 0
3 381 1529 256 256 1 15 16 35 1 1 1 0
3 810 1529 256 256 3 0 17 35 1 0 0 0

6 4280 1529 256 256 1 0
6 4742 1529 256 256 1 0
6 5232 1529 256 256 1 0
6 5734 1529 256 256 1 0
6 6196 1529 256 256 1 0
6 6722 1529 256 256 1 0

6 7081 484 256 256 1 0
6 4959 484 256 256 1 0
6 2777 484 256 256 1 0
6 1153 484 256 256 1 0
6 2619 1529 256 256 1 0
6 1063 2603 256 256 1 0

6 1000 2603 32 64 1 0
6 6723 2603 32 256 0 0

6 4996 429 830 320 1 0
6 6853 416 1256 330 1 0

6 595 2507 680 353 0 0
6 670 1600 1 300 1 0

7 7175 2615 49
7 7175 1541 50

8 0 0 1024 256 0 1 25 4 2 1 0
8 0 0 512 300 0 1 40 1 1 1 0
8 0 0 256 256 0 1 58 11 2 1 0

8 627 444 869 451 0 1 57 0 0 0 0
8 2648 444 512 256 0 1 52 0 0 0 0
8 2808 444 869 451 0 1 57 0 0 0 0
8 4787 444 869 451 0 1 57 0 0 0 0
8 5187 444 869 451 0 1 57 0 0 0 0
8 6755 444 869 451 0 1 57 0 0 0 0
8 7325 444 869 451 0 1 57 0 0 0 0

8 2556 1488 869 451 0 1 56 0 0 0 1

8 4003 1519 869 451 0 1 57 0 0 0 0
8 4455 1519 869 451 0 1 57 0 0 0 0
8 4946 1519 869 451 0 1 57 0 0 0 0
8 5431 1519 869 451 0 1 57 0 0 0 0
8 5910 1519 869 451 0 1 57 0 0 0 0
8 6436 1519 869 451 0 1 57 0 0 0 0
8 6919 1519 512 256 0 1 52 0 0 0 0

8 505 2565 869 451 0 1 57 0 0 0 0

8 2854 2595 512 256 0 1 52 0 0 0 0
8 3312 2595 869 451 0 1 57 0 0 0 0
8 3905 2595 869 451 0 1 57 0 0 0 0
8 4508 2595 869 451 0 1 57 0 0 0 0
8 5051 2595 869 451 0 1 57 0 0 0 0
8 5591 2595 869 451 0 1 57 0 0 0 0
8 6135 2595 869 451 0 1 57 0 0 0 0
8 6615 2595 869 451 0 1 57 0 0 0 0

9 2560 2603 256 256 35 1 1 0 5 1 255 0 0
9 4587 2603 256 256 35 1 1 0 5 1 255 0 0
9 1000 2703 32 64 47 1 2 0 0 0 255 0 0
9 6723 2703 32 32 46 1 2 0 2 0 255 0 0
9 6853 416 1256 330 27 0 3 0 0 0 255 0 0
9 4996 429 830 320 27 0 3 0 0 0 255 0 0
9 820 1526 256 256 36 1 0 0 22 1 255 0 0

9 2564 2603 256 256 62 0 3 0 8 0 255 1 1
9 2820 2603 256 256 62 0 3 0 8 0 255 1 1
9 3076 2603 256 256 62 0 3 0 8 0 255 1 1
9 3332 2603 256 256 62 0 3 0 8 0 255 1 1
9 3588 2603 256 256 62 0 3 0 8 0 255 1 1
9 3844 2603 256 256 62 0 3 0 8 0 255 1 1
9 4100 2603 256 256 62 0 3 0 8 0 255 1 1
9 4356 2603 256 256 62 0 3 0 8 0 255 1 1
9 4612 2603 256 256 62 0 3 0 8 0 255 1 1
9 4868 2603 256 256 62 0 3 0 8 0 255 1 1
9 5124 2603 256 256 62 0 3 0 8 0 255 1 1
9 5380 2603 256 256 62 0 3 0 8 0 255 1 1
9 5636 2603 256 256 62 0 3 0 8 0 255 1 1
9 5892 2603 256 256 62 0 3 0 8 0 255 1 1
9 6148 2603 256 256 62 0 3 0 8 0 255 1 1
9 6404 2603 256 256 62 0 3 0 8 0 255 1 1
9 6660 2603 256 256 62 0 3 0 8 0 255 1 1
9 6916 2603 256 256 62 0 3 0 8 0 255 1 1
9 7172 2603 179 256 62 0 3 0 8 0 255 1 1

9 2983 2603 256 256 36 1 0 0 22 1 255 0 0

11 60 60 65 2