0 100 44 256 256 6
1 0 44 256 256 0 4 2980 3700 21 0
2 1383 40 17 260 0
2 2279 40 17 260 1
4 100 44 512 256 0 29 4
4 100 44 256 256 0 28 4
3 7720 44 255 255 4 0 1 23 0 1 0
5 1717 44 256 256 24
5 2809 44 256 256 26
5 3217 44 256 256 24
5 4179 44 256 256 26
6 1650 100 20 100 1 0
6 1320 100 20 100 1 21
6 2216 100 20 100 1 21
6 6900 100 20 100 1 0
8 0 0 1024 256 0 1 25 4 2 1
8 0 0 512 256 0 1 40 1 1 1
8 1700 0 512 300 0 1 43 8 1 0
9 -527 0 1920 1080 27 0 3 0 1 0 255 0 0
9 2295 0 1920 1080 27 1 3 0 1 0 255 0 0
9 1694 0 512 300 44 1 3 0 8 0 255 0 0
10 0 20 10000 19
10 0 300 10000 19
11 0 0 0 3