0 100 44 256 256 6

1 0 44 256 256 0 4 2850 3700 21 0

2 1383 40 17 260 0
2 2279 40 17 260 1
2 0 0 1 256 1
2 8190 0 1 256 1

3 7720 44 255 255 4 0 1 35 0 1 0

5 1717 44 256 256 24
5 2809 44 256 256 26
5 3217 44 256 256 24
5 4179 44 256 256 26

6 1650 100 20 200 1 0
6 1320 100 20 200 1 21
6 2236 100 20 200 1 21
6 6900 100 20 200 1 0

8 0 0 1024 256 0 1 25 4 2 1 0
8 0 0 512 300 0 1 40 1 1 1 0
8 0 0 256 256 0 1 58 12 2 1 0
8 1700 42 512 256 0 1 52 0 1 0 1

9 -527 0 1920 1080 27 0 3 0 1 0 255 0 0
9 2295 0 1920 1080 27 1 3 0 1 0 255 0 0
9 1694 42 512 256 51 1 0 0 8 0 255 0 0
9 1313 42 256 256 64 0 1 0 5 0 255 0 0
9 1313 42 256 256 64 1 1 0 5 1 255 0 0
9 2215 42 256 256 64 1 1 0 5 0 255 0 0
9 2215 42 256 256 64 0 1 0 5 1 255 0 0

10 0 20 10000 19
10 0 300 10000 19

11 0 0 0 3