-0 0 84 256 256 6
-1 0 84 256 256 0 4 2980 3700 21 0
-2 1383 80 17 260 0
-2 2279 80 17 260 1
-3 7720 84 255 255 4 0 1 35 0 1 0
-4 100 84 512 256 0 29 4
-4 100 84 256 256 0 28 4
-5 1717 84 256 256 24
-5 2809 84 256 256 26
-5 3217 84 256 256 24
-5 4179 84 256 256 26
-6 1650 150 20 100 1 0
-6 1320 150 20 100 1 21
-6 2216 150 20 100 1 21
-6 6900 150 20 100 1 0
-8 0 0 1024 256 0 1 25 4 2 1
-8 0 0 512 256 0 1 40 1 1 1
-8 32 0 512 300 0 1 43 8 1 0
-9 -527 0 1920 1080 27 0 3 0 1 0 255 0 0
-9 2295 0 1920 1080 27 1 3 0 1 0 255 0 0
-9 28 0 512 300 44 1 2 0 8 0 255 0 0
-10 0 0 10000 19
-10 0 340 10000 19
-11 200 200 200