0 50 344 256 256 6 0

1 6500 44 256 256 0 4 6500 6500 21 0
1 1900 344 256 256 0 4 1900 2750 21 1
1 4650 344 256 256 0 4 4650 4650 21 1

2 7810 44 10 256 1
2 0 344 1 256 1
2 5553 344 1 256 1
2 2211 44 1 256 1

3 5239 344 256 256 4 2 1 0 1 0 0 1
3 2572 44 256 256 4 1 2 0 1 0 0 1

5 1455 344 256 256 26
5 2324 344 256 256 26
5 3305 344 256 256 26
5 3944 344 256 256 26
5 6913 44 256 256 26

6 7525 44 10 256 1 0
6 7781 44 10 256 1 21
6 7900 44 10 256 1 0
6 2563 76 500 200 1 0
6 5161 376 500 200 0 0

7 5333 356 49
7 2710 56 50

8 0 0 1024 256 0 1 25 4 2 1 0
8 0 0 512 300 0 1 40 1 1 1 0
8 0 0 256 256 0 1 58 11 2 1 0

8 2502 340 869 458 0 1 57 1 1 0 1
8 7192 40 869 260 0 1 57 0 0 0 0

9 7810 0 1920 1080 27 1 3 0 1 0 255 0 0
9 8125 0 2000 300 27 1 3 1 1 1 255 0 0
9 7730 44 256 256 64 1 1 0 5 0 255 0 0
9 7730 44 256 256 64 0 1 0 5 1 255 0 0

9 2200 0 5925 300 27 1 3 0 1 0 255 0 0
9 0 300 5555 300 27 0 3 0 1 0 255 0 0

10 2211 300 5914 1
10 2211 43 5914 1
10 0 600 5552 1
10 0 343 5552 1

11 0 0 0 4