0 227 944 256 256 6

1 4586 944 256 256 0 4 4378 5042 21 1

2 -2 940 2 260 1
2 5528 940 1 260 1
2 1557 340 1 260 1
2 5522 340 1 260 1
2 1557 40 1 260 1
2 5522 40 1 260 1

3 3133 944 256 256 6 2 1 23 1 0 0
3 2911 344 256 256 6 1 2 23 1 0 0
3 2121 344 256 256 6 4 3 23 1 0 0
3 2365 44 256 256 6 3 4 23 1 0 0

5 2394 944 256 256 26
5 3787 944 256 256 26

6 600 944 20 256 1 0

7 3261 900 49
7 3039 300 50
7 2249 300 49
7 2493 0 50

8 0 0 1024 256 0 1 25 4 2 1 0
8 0 0 512 300 0 1 40 1 1 1 0
8 0 0 256 256 0 1 58 12 2 1 0

9 700 944 128 256 60 1 1 0 1 0 255 0 0
9 700 944 128 256 61 0 1 0 3 0 255 1 1

9 0 944 256 256 62 1 3 0 8 0 255 1 1
9 256 944 256 256 62 0 3 0 8 0 255 1 1
9 512 944 256 256 62 0 3 0 8 0 255 1 1
9 768 944 256 256 62 0 3 0 8 0 255 1 1
9 1024 944 256 256 62 0 3 0 8 0 255 1 1
9 1280 944 256 256 62 0 3 0 8 0 255 1 1
9 1536 944 256 256 62 0 3 0 8 0 255 1 1
9 1792 944 256 256 62 0 3 0 8 0 255 1 1
9 2048 944 256 256 62 0 3 0 8 0 255 1 1
9 2304 944 256 256 62 0 3 0 8 0 255 1 1
9 2560 944 256 256 62 0 3 0 8 0 255 1 1
9 2816 944 256 256 62 0 3 0 8 0 255 1 1
9 3072 944 256 256 62 0 3 0 8 0 255 1 1
9 3328 944 256 256 62 0 3 0 8 0 255 1 1
9 3584 944 256 256 62 0 3 0 8 0 255 1 1
9 3840 944 256 256 62 0 3 0 8 0 255 1 1
9 4096 944 256 256 62 0 3 0 8 0 255 1 1
9 4352 944 256 256 62 0 3 0 8 0 255 1 1
9 4608 944 256 256 62 0 3 0 8 0 255 1 1
9 4864 944 256 256 62 0 3 0 8 0 255 1 1
9 5120 944 256 256 62 0 3 0 8 0 255 1 1
9 5376 944 153 256 62 1 3 0 8 0 255 1 1


10 0 1200 5530 1
10 0 940 4187 1
10 4357 940 1173 1
10 0 600 4187 1
10 4357 600 1173 1
10 1555 340 3967 1
10 1555 300 3967 1
10 1555 40 3967 1

11 0 0 0 6