0 0 0 256 256 6
2 -4098 0 1 256 1
4 428 0 128 256 100 59 2 0
4 300 0 128 256 100 60 2 0
4 1350 0 128 256 100 62 2 0
4 1750 0 128 256 100 63 2 0
4 3500 0 128 256 100 64 2 0
4 4250 0 128 256 100 67 2 0
4 5328 0 128 256 100 65 2 0
4 5250 0 128 256 100 66 2 0
6 8870 0 1000 256 1 0
6 300 0 128 256 1 0
6 1350 0 128 256 1 0
6 1750 0 128 256 1 0
6 3500 0 128 256 1 0
6 4250 0 128 256 1 0
6 5250 0 128 256 1 0
8 0 0 1024 256 0 1 25 4 2 1 0
8 0 0 512 300 0 1 40 1 1 1 0
8 0 0 256 256 0 1 58 12 2 1 0
11 200 200 200 7