0 10 341 256 256 6 0
0 10 86 256 256 6 69

1 10 341 256 256 1 4 1900 1900 21 0

2 0 86 1 511 1
2 2156 596 1 1 1

5 1800 341 256 256 24

6 2000 500 1 1 1 0
6 2181 500 1 1 1 0
6 3888 192 1 1 1 69

8 0 0 1024 256 0 1 25 4 2 1 0
8 0 0 512 300 0 1 40 1 1 1 0
8 0 0 256 256 0 1 58 11 2 1 0

8 2039 134 869 451 0 1 57 0 0 0 0
8 1039 134 869 451 0 1 57 0 0 0 0
8 2039 444 869 451 0 1 57 0 0 0 0

11 0 0 0 7