0 10 440 256 256 6
1 1005 412 100 100 0 0 1005 1005 1 0
2 0 0 1 696 1
2 1311 0 1 696 1
4 1100 440 256 256 0 83 4 0
6 1200 0 1 696 1 0
6 1200 0 1 696 0 1
8 0 0 1024 256 0 1 25 4 2 1 0
8 0 0 512 300 0 1 40 1 1 1 0
8 0 0 256 256 0 1 58 12 2 1 0
9 1311 162 51 534 90 1 3 0 0 0 255 0 0
11 200 200 200 7